map 0 //////////


111111111111111111111111111111111111111111111111
112000011000000000000010000000011000000000000011
110002011000000000000010000000011000000200000011
110000000000000000000010000000011000000000000011
112000011000000000000010000000000000020000000011
110000011000000001000000000000000110000000000011
1100N0000000000001000000002200000110000020000011
110000000000000001000000000000000110000000000011
111111111111111111111111111111111111111111111111





map 1 /////////


11111111111111111111111111111111111111111111111111111111111
11000000110110000001100000000000000000110000000000000000011
11000110000110000001100000000000111111110000010000200000011
11000111111111000001111111100000110000000000010000000000011
10000000000000200000000011011001100111101100100000111111111
11111111111111111111111111111111111111111111111111111111111
11111111111111111111111111111111111111111111111111111111111
11111111111110000000111111101110011001111110011111110000011
11000S00000020000001000000000000011001100000000000000000111
11000000000000001110000110011000011001100000000011111111111
11000111111001001000220010001100000000000000100000000000011
11000100001001001001100110001100011111111100100111111111111
11100100101001111001100110001100011001000000001000100010011
11000100100000000000000000001100000001101100100010001000111
11111111111111111111111111111111111111111111111111111111111






map 2 ////////////

                                111
                                121
                                101
                                101
                                1N1
                                101
                                101
                                101
                                101
                                101
                                101
                                101
                                101
                                101
                                101
                                101
                                101
                                101
                                101
                                101
                                101
                                101
                                101
                                101
                                101
                                101
                                101
                                101
     111111111111111111111111111101
     100000000000000000000000000001
     101111111111111111111111111101
     101                        101
     101                        101
     101                        101
     101      111111111111111111101
     101      100000000000000000001
     101      101111111111111111101
     101      101               101
     101      101111111111111111101
     101      100000000000000000001
     101      111111111111111111101
     101                        101
     101                        101
     101                        101
     101                        101
     101                        101111111111111111111
     101                        10000000000000000000111111111111
     101                        101111111111111111100000000000011111111111111111111111111
     101                        101200000000000000000000000000000000000000000000000000001
     101                        101111111111111111100000000000011111111111111111111111111
     101                        10000000000000000000111111111111
     101                        101111111111111111111
     101                        101
     101                        101
     101                        10111111111111111111111111111111111
11111101111111111               10000000000000000000000000000000001           
10000000000000001               10111111111111111111111111111111101
10202020002020201               101                             101
10000000000000001        11111111011111111                      101
10002000200200001        12000000000000021                      101
10000000000000001        10020000000020001                      101
10000000000000001        10000000000000001                      101
10000000000000001        10000000000000001                      101
10000000000000001        10200000000200001                      101
10000000000000001        10000000000000001                      101
10200000200002001111111111000000000000000111111111111111111111111011111111111111111111111111111111111111111111111111111111111111111111111111111111111111111111111111111111111111111111111111111111111111111111111111111111111111111111111111111111111111111111111111111111111111111111111111111111111111111111111111111111111111111111111111111111111111111111111111111111111111111111111111111111111111111111111111111111111111111111111111111111111111111111111111111111111111111111111111111111111111111111111111111111111111111111111111111111111111111111111111111111111111111111111111111111111111111111111111111111111111111111111111111111111111111111111111111111111111111111111111111111111111111111111111111111111111111111111111111111111111111111111111111111111111111111111111111111111111111111111111111111111111111111111111111111111111111111111111111111111111111111111111111111111111111111111111111111111111111111111111111111111111111111
10000000000000000000000000000000000000000000000000000000000000000000000000000000000000000000000000000000000000000000000000000000000000000000000000000000000000000000000000000000000000000000000000000000000000000000000000000000000000000000000000000000000000000000000000000000000000000000000000000000000000000000000000000000000000000000000000000000000000000000000000000000000000000000000000000000000000000000000000000000000000000000000000000000000000000000000000000000000000000000000000000000000000000000000000000000000000000000000000000000000000000000000000000000000000000000000000000000000000000000000000000000000000000000000000000000000000000000000000000000000000000000000000000000000000000000000000000000000000000000000000000000000000000000000000000000000000000000000000000000000000000000000000000000000000000000000000000000000000000000000000000000000000000000000000000000000000000000000000000000000000000000000000000000000001
11111011111111111111111111000000000000000111111111111111111111111011111111111111111111111111111111111111111111111111111111111111111111111111111111111111111111111111111111111111111111111111111111111111111111111111111111111111111111111111111111111111111111111111111111111111111111111111111111111111111111111111111111111111111111111111111111111111111111111111111111111111111111111111111111111111111111111111111111111111111111111111111111111111111111111111111111111111111111111111111111111111111111111111111111111111111111111111111111111111111111111111111111111111111111111111111111111111111111111111111111111111111111111111111111111111111111111111111111111111111111111111111111111111111111111111111111111111111111111111111111111111111111111111111111111111111111111111111111111111111111111111111111111111111111111111111111111111111111111111111111111111111111111111111111111111111111111111111111111111111111111111111111111111111111
    101                  10000000000002001                      101
    101                  10020000000000001                      101
    101                  10000000000000001                      101
    101                  10000000000000001                      101
    101                  10002000000200001                      101
11111011111111111        12000000000000021                      101
10000000000000001        11111111011111111                      101
10200000200000201              12021                            101
1000000000000000111111111111111120211111111111111111111111111111101
1000200020002000000000000000000000000000000000000000000000000000001
1111111111111111101111111111011120211101111111111011111111111111111
                101        101 12021 101        101      
                101        101 12021 101        101      
                101        101 12021 101        101      
                101        1011120211101        101      
                101        1000000000001        101      
                101        1111120211111        101      
                101            12021            101 
                101            12021            101 
                101            12021            101 
                101            12021            101 
                101            12021            101 
                101            12021            101 
                101            12021            101 
                101            12021            101 
                101            12021            101 
                101            12021            101 
                101            12021            101 
                101            12021            101
                101            12021            101
                101            12021            101
                10111111111111112021111111111111101
                10000000000000000000000000000000001
                11111111111111112021111111111111111
                               12021
                               12021
                               12021
                               12021
                               12021
                               12021
                               12021
                               12021
                               12021
                               12021
                               12021
                               12021
                               12021
                               12021
                               12021
                               12021
                               12021
                               12021
                               12021
                               12021
                               12021
                               12021
                               12021
                               12021
                               12021
                               12021
                               12021
                               12021
                               12021
                11111111111111 12021 11111111111111111111111111111111
                10000000000001 12021 10000000000000000000000000000001      
                10111111111101 12021 10111111111111111111111111111101      
                101        101 12021 101                          101      
                101        1011110111101                          101      
                101        1000000000001                          101      
                101        1111110111111                          101      
                101        1202020202021                          101 
                101        1202020202021                          101 
                101        1202020202021                          101 
                101        1202020202021                          101 
                101        1202020202021                          101 
                101        1202020202021                          101 
                101        1202020202021                          101 
                101        1202020202021                          101 
                101        1202020202021                          101 
                101        1202020202021                          101 
                101        1202020202021                          101 
                101        1202020202021                          101
                101        1202020202021                          101
                101        1202020202021                          101
                10111111111111111011111111111111111111111111111111101
                10000000000000000000000000000000000000000000000000001
                11111111111111111011111111111111111111111111111111111
                               12021
                               12021
                               12021
                               12021
                               12021
                               12021
                               12021
                               12021
                               12021
                               12021
                               12021
                               12021
                               12021
                               12021
                               12021
                               12021
                               12021
                               12021
                               12021
                               12021
                               12021
                               12021
                               12021
                               12021
                               12021
                               12021
                               12021
                               12021
                               12021
                               12021
                               12021
                               12021
                               12021
                               12021
                               12021
                               12021
                               12021
                               1111
