R    1500 1000
WE  ./sma9lo/file
NO  ./taha   
EA  ./lmeki 
SO  ./saleh  
S   ./etazi
F   10,10,20
C   10,10,90


11111111111111111111111111111111111111111111111111111111111
11000000000000000000000000000000000000000000000000000000011
11000000000000000000000000000000000000000000000000200000011
11000000000000000000000000000000000000000000000000000000011
11000000000000000000000001101100110011110110000000011111111
11111111111110000000111111101110011001111110010010010000011
11000000000000000001000000000000001100110000000000000000011
11000000000000001110000110011000011001100000000011111111111
11000111111001001000000010001100000000000000100000000000011
11000100001001001001100110001100011111111100100111111111111
11100100101001111001100110001100011001000000000000000010011
1100N100100000000000000000001100000001101100100000001000111
11111111111111111111111111111111111111111111111111111111111
                       1
                      101
                     10001
                    1000001
                   100000001
                  11111111111
11111111111111111111111111111111111111111111111111111111111111111111
11                                                                11
11                                                                11
11   111111111111111  1111  111111111111111     111111111111111   11
11   11111111111111   1111  1111111111111111    111111111111111   11
11   111              1111  111           111   1111       1111   11
11   111              1111  111            111  111         111   11
11   111111111        1111  111            111  111         111   11
11   11111111         1111  111           111   111         111   11
11   111              1111  1111111111111111    111         111   11
11   111              1111  1111111111111111    111         111   11
11   111              1111  111           111   111         111   11
11   111              1111  111            111  111         111   11
11   111              1111  111            111  111         111   11
11   111              1111  111           111   1111       1111   11
11   111              1111  1111111111111111    111111111111111   11
11   111              1111  111111111111111     111111111111111   11
11                                                                11
11                                                                11
11111111111111111111111111111111111111111111111111111111111111111111