R   1000  1000      //resolution
WE  ./              // western walls textures
NO  ./              // northern walls textures
EA  ./              // eastern walls textures
SO  ./              // southern walls textures
F   50,50,50        // floor color
C   10,10,10        // ceiling color




11111111111111111111111111111111111111111111111111111111111
11                              1      11     1          11
11                       11 11111  111111     1       G  11
11   1111111111111111111111 1            11 11111  1     11
11                       11 11  11  1111 11     1  11111111
1111111111111       1111111 111  11  111111  1  1  1     11
11               111              11  11     1           11
11              111    11   11    11  11    1   11111111111
11   111111  1  1      11   11              1            11
11   1    1  1  1  11  11   11   111111111  1  111111111111
111  1  1 1  1111  11  11   11   11  1      1     1   1  11
11  N1  1          11       11      111 11  1       1   111
11111111111111111111111111111111111111111111111111111111111