WE  ./textures/we.xpm
NO  ./textures/no.xpm
EA  ./textures/ea.xpm
SO  ./textures/so.xpm
S   ./textures/sp1.xpm
R 2048 1152
F   20,100,3
C   0,10,255




11111111111111111111111111111111111111111111111111111111111
11000000110110000001100000000000000000110000000000000000011
11000110000110000001100000000000111111110000010000200000011
11000111111111000001111111100000110000000000010000000000011
11000000000000020000000001101100110011110110010000011111111
11111111111110000000111111101110011001111110011111110000011
11000000000020000001000000000000001100110000000000000000011
11000000000000001110000110011000011001100000000011111111111
11002111111001001000220010001100000000000000100000000000011
11000100001001001001100110001100011111111100100111111111111
11100100101001111001100110001100011001000000001000100010011
1100N100100000000000000000001100000001101100100010001000111
11111111111111111111111111111111111111111111111111111111111