
NO ./textures/no.xpm
C 78,175,201
F 255,160,122
EA ./textures/ea.xpm

WE ./textures/we.xpm
SO ./textures/so.xpm
S ./textures/sp1.xpm
R   1000 1000




                                111
                                121
                                101
                                101
                                1N1
                                101
                                101
                                101
                                101
                                101
                                101
                                101
                                101
                                101
                                101
                                101
                                101
                                101
                                101
                                101
                                101
                                101
                                101
                                101
                                101
                                101
                                101
                                101
                                101
                                101
                                101
                                101
                                101
                                101
                                101
                                101
                                101
                                101
                                101
                                101
                                101
                                101
                                101
                                101
                                101
                                101
                                101
                                101
                                101
                                101
                                101
                                101
                                101
                                101
                                10111111111111111111111111111111111
11111111111111111               10000000000000000000000000000000001           
10000000000000001               10111111111111111111111111111111101
10202020002020201               101                             101
10000000000000001        11111111011111111                      101
10002000200200001        12000000000000021                      101
10000000000000001        10020000000020001                      101
10000000000000001        10000000000000001                      101
10000000000000001        10000000000000001                      101
10000000000000001        10200000000200001                      101
10000000000000001        10000000000000001                      101
1020000020000200111111111100000000000000011111111111111111111111101111111111111111111111111111111111111111111111111111111111111111111111111111111111111111111111111111111
1000000000000000000000000000000000000000000000000000000000000000000000000000000000000000000000000000000000000000000000000000000000000000000000000000000000000000000000001
1111101111111111111111111100000000000000011111111111111111111111101111111111111111111111111111111111111111111111111111111111111111111111111111111111111111111111111111111
    101                  10000000000002001                      101
    101                  10020000000000001                      101
    101                  10000000000000001                      101
    101                  10000000000000001                      101
    101                  10002000000200001                      101
11111011111111111        12000000000000021                      101
10000000000000001        11111111011111111                      101
10200000200000201               101                             101
1000000000000000111111111111111110111111111111111111111111111111101
1000200020002000000000000000000000000000000000000000000000000000001
1111111111111111111111111111111110111111111111111111111111111111111
                                101
                                101
                                101
                                101
                                101
                                101
                                101
                                101
                                101
                                101
                                101
                                101
                                101
                                101
                                101
                                101
                                101
                                101
                                101
                                101
                                101
                                101
                                101
                                101
                                101
                                101
                                101
                                101
                                101
                                101
                                101
                                101
                                101
                                101
                                101
                                101
                                101
                                101
                                101
                                101
                                101
                                101
                                101
                                101
                                101
                                101
                                101
                                101
                                101
                                101
                                101
                                101
                                101
                                101
                                101
                                101
                                101
                                101
                                101
                                101
                                101
                                101
                                101
                                101
                                101
                                101
                                101
                                101
                                101
                                101
                                101
                                101
                                101
                                101
                                101
                                101
                                101
                                101
                                101
                                101
                                101
                                101
                                101
                                101
                                101
                                101
                                101
                                111